{
  "name": "E1M2 — Containment Breach",
  "width": 32,
  "height": 32,
  "grid": [
    [1,1,1,1,1,1,1,1,1,1,1,1,1,1,1,1,1,1,1,1,1,1,1,1,1,1,1,1,1,1,1,1],
    [1,0,0,0,0,0,0,0,0,0,0,0,0,1,1,0,0,0,0,0,0,0,0,0,0,0,0,0,0,0,0,1],
    [1,0,0,0,0,0,0,0,0,0,0,0,0,1,1,0,0,0,0,0,0,0,0,0,0,0,0,0,0,0,0,1],
    [1,0,0,2,2,2,0,0,0,0,0,0,0,1,1,0,0,0,0,0,0,0,0,0,3,3,3,0,0,0,0,1],
    [1,0,0,2,0,0,0,0,0,0,0,0,0,0,0,0,0,0,0,0,0,0,0,0,3,0,0,0,0,0,0,1],
    [1,0,0,2,0,0,0,0,0,0,0,0,0,0,0,0,0,0,0,0,0,0,0,0,3,0,0,0,0,0,0,1],
    [1,0,0,2,2,2,0,0,0,0,0,0,0,1,1,0,0,0,0,0,0,0,0,0,3,3,3,0,0,0,0,1],
    [1,0,0,0,0,0,0,0,1,1,1,1,1,1,1,1,1,1,1,1,1,1,1,1,1,0,0,0,0,0,0,1],
    [1,0,0,0,0,0,0,0,1,0,0,0,0,0,0,0,0,0,0,0,0,0,0,0,1,0,0,0,0,0,0,1],
    [1,0,0,0,0,0,0,0,1,0,0,0,0,0,0,0,0,0,0,0,0,0,0,0,1,0,0,0,0,0,0,1],
    [1,1,1,0,1,1,1,1,1,0,0,0,0,0,0,0,0,0,0,0,0,0,0,0,1,1,1,0,1,1,1,1],
    [1,0,0,0,0,0,0,0,0,0,0,0,0,0,0,0,0,0,0,0,0,0,0,0,0,0,0,0,0,0,0,1],
    [1,0,0,0,0,0,0,0,0,0,0,0,0,0,0,0,0,0,0,0,0,0,0,0,0,0,0,0,0,0,0,1],
    [1,0,0,0,0,0,0,0,0,0,0,0,0,0,0,0,0,0,0,0,0,0,0,0,0,0,0,0,0,0,0,1],
    [1,1,1,1,1,1,0,1,1,1,1,0,1,1,1,1,1,0,1,1,1,1,0,1,1,1,1,1,0,1,1,1],
    [1,0,0,0,0,0,0,0,0,0,1,0,1,0,0,0,0,0,0,0,0,1,0,0,0,0,0,0,0,0,0,1],
    [1,0,0,0,0,0,0,0,0,0,1,0,1,0,0,0,0,0,0,0,0,1,0,0,0,0,0,0,0,0,0,1],
    [1,0,0,0,0,0,0,0,0,0,1,0,1,0,0,0,4,0,0,0,0,1,0,0,0,0,0,0,0,0,0,1],
    [1,1,1,1,1,0,1,1,1,1,1,0,1,1,1,0,4,0,1,1,1,1,1,0,1,1,1,1,1,1,1,1],
    [1,0,0,0,0,0,0,0,0,0,0,0,0,0,1,0,4,0,0,0,0,0,0,0,0,0,0,0,0,0,0,1],
    [1,0,0,0,0,0,0,0,0,0,0,0,0,0,1,0,0,0,0,0,0,0,0,0,0,0,0,0,0,0,0,1],
    [1,0,0,0,0,0,0,0,0,0,0,0,0,0,1,0,0,0,0,0,0,0,0,0,0,0,0,0,0,0,0,1],
    [1,1,1,1,1,1,1,1,0,1,1,1,1,1,1,0,0,0,1,1,1,1,0,1,1,1,1,1,1,1,1,1],
    [1,0,0,0,0,0,0,1,0,0,0,0,0,0,0,0,0,0,0,0,0,1,0,0,0,0,0,0,0,0,0,1],
    [1,0,0,0,0,0,0,1,0,0,0,0,0,0,0,0,0,0,0,0,0,1,0,0,0,0,0,0,0,0,0,1],
    [1,0,0,0,0,0,0,1,0,0,0,0,0,0,0,0,0,0,0,0,0,1,0,0,0,0,0,0,0,0,0,1],
    [1,0,0,0,0,0,0,0,0,0,0,0,0,0,0,0,0,0,0,0,0,0,0,0,0,0,0,0,0,0,0,1],
    [1,0,0,0,0,0,0,0,0,0,0,0,0,0,0,0,0,0,0,0,0,0,0,0,0,0,0,0,0,0,0,1],
    [1,0,0,0,0,0,0,0,0,0,0,0,0,0,0,0,0,0,0,0,0,0,0,0,0,0,0,0,0,0,0,1],
    [1,0,0,0,0,0,0,0,0,0,0,0,0,0,0,0,0,0,0,0,0,0,0,0,0,0,0,0,0,0,5,1],
    [1,1,1,1,1,1,1,1,1,1,1,1,1,1,1,1,1,1,1,1,1,1,1,1,1,1,1,1,1,1,1,1]
  ],
  "spawn": { "x": 1.5, "y": 1.5, "angle": 0.3 },
  "wallTypes": {
    "1": { "name": "Stone Wall",   "color": [180,  60,  60] },
    "2": { "name": "Brick Wall",   "color": [ 60, 180,  60] },
    "3": { "name": "Tech Panel",   "color": [ 60,  60, 180] },
    "4": { "name": "Energy Field", "color": [180, 180,  60] },
    "5": { "name": "Exit Door",    "color": [  0, 255,  0] }
  },
  "enemies": [
    { "type": "imp", "x": 4.5, "y": 5.5 },
    { "type": "imp", "x": 6.5, "y": 1.5 },
    { "type": "imp", "x": 10.5, "y": 3.5 },
    { "type": "imp", "x": 15.5, "y": 9.5 },
    { "type": "imp", "x": 21.5, "y": 5.5 },
    { "type": "imp", "x": 25.5, "y": 1.5 },
    { "type": "imp", "x": 5.5, "y": 12.5 },
    { "type": "imp", "x": 15.5, "y": 16.5 },
    { "type": "imp", "x": 20.5, "y": 18.5 },
    { "type": "imp", "x": 10.5, "y": 20.5 },
    { "type": "imp", "x": 25.5, "y": 17.5 },
    { "type": "imp", "x": 20.5, "y": 25.5 },
    { "type": "imp", "x": 28.5, "y": 28.5 }
  ],
  "pickups": [
    { "x": 3.5, "y": 3.5, "type": "health", "amount": 25 },
    { "x": 12.5, "y": 5.5, "type": "health", "amount": 25 },
    { "x": 24.5, "y": 4.5, "type": "health", "amount": 25 },
    { "x": 7.5, "y": 13.5, "type": "pistol_ammo", "amount": 12 },
    { "x": 17.5, "y": 17.5, "type": "pistol_ammo", "amount": 12 },
    { "x": 22.5, "y": 21.5, "type": "pistol_ammo", "amount": 12 },
    { "x": 11.5, "y": 25.5, "type": "shotgun_ammo", "amount": 4 },
    { "x": 26.5, "y": 25.5, "type": "shotgun_ammo", "amount": 4 },
    { "x": 15.5, "y": 27.5, "type": "health", "amount": 25 },
    { "x": 20.5, "y": 27.5, "type": "shotgun_ammo", "amount": 4 }
  ]
}